22222222222222222222222222222222222222222222
2222222220R000000000000000000000000000000002
22222222000000000000000000000000000000000002
22222220001110000000000000000000000000000002
22222200000000000000000000000000000000000002
22222000000000000000000000000000000000000222
22220000111111110000000000000000000000000222
22200000000000010000000000000000000000000222
22000000000000010000000000000000000000000222
20000000000000010000000000000000000000000222
20000000111111110000000000000000000000000222
20000000000000000001000000000000000000000222
20000000000000000011000000000000000000000002
20000010000000000001000000000000000000000002
20000010000000000011000000000000000000000002
220000100000000J0001000000000000000000000002
22200000000000000000000000000000000000000002
22200000000000000000000000000000000000000002
22200000000000000000000000000000000000000002
22200000000000000000000000000000000000000002
22200000000000000000000000000000000000000002
22222222222222222222222222222222222222222222
