22222222222222222222222222
22222222200000000000000002
22222222000000000000000002
22222220000000000000000002
22222200000000000000000002
22222000000000000000000222
22220000000000000000000222
22200000000000000000000222
22000000000000000000000222
20000000000000000000000222
2000000000000F000000000222
20000000000000000000000222
20000000000000000000000002
200R0000000000000000000002
20000000000000000000000002
22000000000000000000000002
22200000000000000000000002
22222222222222222222222222