22222222222222222222222222
22222222200000000000000002
222222220000000000F0000002
22222220001110000000R00002
22222200000000000000000002
22222000000000000000000222
22220000111111110000000222
22200000000000010000000222
22000000000000010000000222
20000000000000010000000222
20000000111111110000000222
20000000000000000001000222
200S0000000000000011000002
20000010000C00000001000002
20000010000000000011000002
220000100000000J0001000002
22200000000000000000000002
22222222222222222222222222